7
0
1
2
3
4
5
6
13
0 1 7 0 0 0 0 0
0 1 9 0 0 0 0 0
0 2 9 0 0 0 0 0
0 2 10 0 0 0 0 0
0 5 14 0 0 0 0 0
1 2 10 0 0 0 0 0
1 3 15 0 0 0 0 0
2 3 11 0 0 0 0 0
2 5 2 0 0 0 0 0
2 5 10 0 0 0 0 0
3 4 6 0 0 0 0 0
4 5 9 0 0 0 0 0
4 6 3 0 0 0 0 0