11
ATL
PEK
DXB
ORD
HND
LHR
LAX
HKG
CDG
DFW
IST
11
ATL PEK 7 0 0 0 0 0
PEK DXB 7 0 0 0 0 0
DXB ORD 7 0 0 0 0 0
ORD HND 7 0 0 0 0 0
HND LHR 7 0 0 0 0 0
LHR LAX 7 0 0 0 0 0
LAX HKG 7 0 0 0 0 0
HKG CDG 7 0 0 0 0 0
CDG DFW 7 0 0 0 0 0
DFW IST 7 0 0 0 0 0
IST ATL 7 0 0 0 0 0