50
0
1
2
3
4
5
6
7
8
9
10
11
12
13
14
15
16
17
18
19
20
21
22
23
24
25
26
27
28
29
30
31
32
33
34
35
36
37
38
39
40
41
42
43
44
45
46
47
48
49
50
0 0 1 0 0 0 0 0
1 0 1 0 0 0 0 0
2 0 1 0 0 0 0 0
3 0 1 0 0 0 0 0
4 0 1 0 0 0 0 0
5 0 1 0 0 0 0 0
6 0 1 0 0 0 0 0
7 0 1 0 0 0 0 0
8 0 1 0 0 0 0 0
9 0 1 0 0 0 0 0
10 0 1 0 0 0 0 0
11 0 1 0 0 0 0 0
12 0 1 0 0 0 0 0
13 0 1 0 0 0 0 0
14 0 1 0 0 0 0 0
15 0 1 0 0 0 0 0
16 0 1 0 0 0 0 0
17 0 1 0 0 0 0 0
18 0 1 0 0 0 0 0
19 0 1 0 0 0 0 0
20 0 1 0 0 0 0 0
21 0 1 0 0 0 0 0
22 0 1 0 0 0 0 0
23 0 1 0 0 0 0 0
24 0 1 0 0 0 0 0
25 0 1 0 0 0 0 0
26 0 1 0 0 0 0 0
27 0 1 0 0 0 0 0
28 0 1 0 0 0 0 0
29 0 1 0 0 0 0 0
30 0 1 0 0 0 0 0
31 0 1 0 0 0 0 0
32 0 1 0 0 0 0 0
33 0 1 0 0 0 0 0
34 0 1 0 0 0 0 0
35 0 1 0 0 0 0 0
36 0 1 0 0 0 0 0
37 0 1 0 0 0 0 0
38 0 1 0 0 0 0 0
39 0 1 0 0 0 0 0
40 0 1 0 0 0 0 0
41 0 1 0 0 0 0 0
42 0 1 0 0 0 0 0
43 0 1 0 0 0 0 0
44 0 1 0 0 0 0 0
45 0 1 0 0 0 0 0
46 0 1 0 0 0 0 0
47 0 1 0 0 0 0 0
48 0 1 0 0 0 0 0
49 0 1 0 0 0 0 0