11
0
1
2
3
4
5
6
7
8
9
lst
18
0 1 7 0 0 0 0 0
0 1 9 0 0 0 0 0
0 2 2 0 0 0 0 0
0 2 3 0 0 0 0 0
0 5 14 0 0 0 0 0
1 2 3 0 0 0 0 0
1 3 15 0 0 0 0 0
2 3 11 0 0 0 0 0
2 5 2 0 0 0 0 0
2 5 10 0 0 0 0 0
3 4 6 0 0 0 0 0
4 5 9 0 0 0 0 0
5 6 1 0 0 0 0 0
6 2 1 0 0 0 0 0
6 7 3 0 0 0 0 0
7 8 4 0 0 0 0 0
8 9 2 0 0 0 0 0
9 lst 1 0 0 0 0 0